XXXXXXXXXXXXXXXXXXXXXXXXXXXXXXXXXXXXXXXXXXXXXXXX
,,,,,,,,,,,,,,,,,,,,,,,,,,,,,,,,,,,,,,,,,,,,,,,,
XXXXXXXXXXXXXXXXXXXXXXXXXXXXXXXXXXXXXXXXXXXXXXXX
,,,,,,,,,,,,,,,,,,,,,,,,,,,,,,,,,,,,,,,,,,,,,,,,
XXXXXXXXXXXXXXXXXXXXXXXXXXXXXXXXXXXXXXXXXXXXXXXX
,,,,,,,,,,,,,,,,,,,,,,,,,,,,,,,,,,,,,,,,,,,,,,,,
XXXXXXXXXXXXXXXXXXXXXXXXXXXXXXXXXXXXXXXXXXXXXXXX
,,,,,,,,,,,,,,,,,,,,,,,,,,,,,,,,,,,,,,,,,,,,,,,,
,,,,,,,,,,,,,,,,,,,,,,,,,,,,,,,,,,,,,,,,,,,,,,,,
,,,,,,,,,,,,,,,,,,,,,,,,,,,,,,,,,,,,,,,,,,,,,,,,
,,,,,,,,,,,,,,,,,,,,,,,,,,,,,,,,,,,,,,,,,,,,,,,,
,,,,,,,,,,,,,,,,,,,,,,,,,,,,,,,,,,,,,,,,,,,,,,,,
,,,,,,,,,,,,,,,,,,,,,,,,,,,,,,,,,,,,,,,,,,,,,,,,
,,,,,,,,,,,,,,,,,,,,,,,,,,,,,,,,,,,,,,,,,,,,,,,,
,,,,,,,,,,,,,,,,,,,,,,,,,,,,,,,,,,,,,,,,,,,,,,,,
,,,,,,,,###,,,##,,,,##,,,###,,,,,,,,,,,,,,,,,,,,
,,,,,,.#,,,,,#,,#,,#,,#,,#,,#,,,,,,,,,,,,,,,,,,,
,,,,,,,#,#,,,#,,#,,#,,#,,#,,#,,,,,,,,,,,,,,,,,,,
,,,,,,,#,,#,,#,,#,,#,,#,,#,,#,,,,,,,,,,,,,,,,,,,
,,,,,,,#,,#,,#,,#,,#,,#,,#,,#,,,,,,,,,,,,,,,,,,,
,,,,,,,,##,,,,##,,,,##,,,###,,,,,,,,,,,,,,,,,,,,
,,,,,,,,,,,,,,,,,,,,,,,,,,,,,,,,,,,,,,,,,,,,,,,,
,,,,,,,#,,,,,#,,#,,,##,,,#,,#,,,,,,,,,,,,,,,,,,,
,,,,,,,#,,,,,#,,#,,#,,#,,#,#,,,,,,,,,,,,,,,,,,,,
,,,,,,,#,,,,,#,,#,,#,,,,,##,,,,,,,,,,,,,,,,,,,,,
,,,,,,,#,,,,,#,,#,,#,,,,,#,#,,,,,,,,,,,,,,,,,,,,
,,,,,,,#,,,,,#,,#,,#,,#,,#,,#,,,,,,,,,,,,,,,,,,,
,,,,,,,####,,,##,,,,##,,,#,,#,,,,,,,,,,,,,,,,,,,
,,,,,,,,,,,,,,,,,,,,,,,,,,,,,,,,,,,,,,,,,,,,,,,,
,,,,,,,,,,,,,,,,,,,,,,,,,,,,,,,,,,,,,,,,,,,,,,,,
,,,,,,,,,,,,,,,,,,,,,,,,,@,,,,,,,,,,,,,,,,,,,,,,
,,,,,,,,,,,,,,,,,,,,,,,,,,,,,,,,,,,,,,,,,,,,,,,,